پسر	دختر
پسران	دختران
برادر	خواهر
برادران	خواهران
پدر	مادر
پدربزرگ	مادربزرگ
مرد	زن
شوهر	زن
عمو	عمه
دایی	خاله
شاه	ملکه
داماد	عروس
پسردایی	دختردایی
پسرخاله	دخترخاله
پسرعمو	دخترعمو
پسرعمه	دخترعمه
پسربچه	دختربچه
عمو	زن‌عمو
شوهرعمه	عمه
دایی	زن‌دایی
شوهرخاله	خاله
پدرخوانده	مادرخوانده
ناپدری	نامادری
برادرخوانده	خواهرخوانده
پسرخوانده	دخترخوانده