آب	قطره
بدن	سلول
مدرسه	دانش‌آموز
قرن	سال
سال	ماه
ماه	روز
روز	ساعت
ساعت	دقیقه
دقیقه	ثانیه
جنگل	درخت
کندو	زنبور
کوهستان	کوه
قاره	کشور
کشور	استان
استان	شهر
کتاب	فصل
شعر	بیت
پارچه	نخ
جامعه	فرد
متن	جمله
جمله	کلمه