نامشخص	مشخص
نامرتب	مرتب
ناآگاه	آگاه
ناراحت	راحت
ناامن	امن
نادرست	درست
نالایق	لایق
ناپاک	پاک
ناجوانمرد	جوانمرد
نامعلوم	معلوم
ناشایست	شایسته
ناسازگار	سازگار
نامتناهی	متناهی
نامناسب	مناسب
ناهماهنگ	هماهنگ
ناشناس	شناس
ناخوشایند	خوشایند
ناتوان	توانا
ناکارامد	کارامد
ناشنوا	شنوا
نابینا	بینا
ناهمگون	همگون
نامربوط	مربوط